#...#...#
.#.....#.
..#.#.#..
...###...
#.#####.#
...###...
..#.#.#..
.#.....#.
#...#...#